AFAIK=As Far As I Know
AFK=Away From Keyboard
ASAP=As Soon As Possible
ATK=At The Keyboard
ATM=At The Moment
BFN=Bye For Now
B4N=Bye For Now
BRB=Be Right Back
BTW=By The Way
FAQ=Frequently Asked Questions
FWIW=For What It's Worth
FYI=For Your Information
GAL=Get A Life
GG=Good Game
GMTA=Great Minds Think Alike
IMO=In My Opinion
IOW=In Other Words
IRL=In Real Life
LMAO=Laugh My Ass Off
LOL=Laughing Out Loud
LTNS=Long Time No See
L8R=Later
MTE=My Thoughts Exactly
M8=Mate
NRN=No Reply Necessary
OIC=Oh I See
ROFL=Rolling On The Floor Laughing
ROFLOL=Rolling On The Floor Laughing Out Loud
ROTFLMAO=Rolling On The Floor Laughing My A.. Off
THX=Thank You
TTYL=Talk To You Later
WTF=What The Fuck
WTG=Way To Go!
TFW=That feeling when 
MFW=My face when
MRW=My reaction when
IFYP=I feel your pain
LOL=Laughing out loud
JK=Just kidding
IDC=I don’t care
ILY=I love you
IMU=I miss you
IDC=I don’t care
LMAO=Laughing my ass off
BFF=Best friends forever
omw=on my Way
otw=on the way
lodi=idol
lods=idol
omsim=exactly
oms=exactly
jowa=love partner
charot=just kidding
chz=just kidding
char=just kidding
charing=just kidding
VL=vacation leave
VLs=vacation leaves
TLDR=in summary
HR=human resources
HRs=human resources
CEO=chief executive officer
COO=chief operating officer
CFO=chief finance officer
CHRO=chief human resources officer
CCO=chief communication officer
CDO=chief design officer
CMO=chief marketing officer
CIO=chief information officer
EOD=end of day
KPI=key performance index
KPIs=key performance indices
BPO=Business process outsourcing
TL=team leader
TLs=team leaders
IT=information technology
OT=overtime
VA=virtual assistant
HMO=Health Maintenance Organization
AWOL=absent without leave
PWD=person with disability
PWDs=person with disabilities
DOLE=Department of Labor and Employment
JO=Job offer
JOs=Job offers
NLRC=National Labor Relations Commission
POC=point of contact
PTO=paid time off
WOM=word of mouth
PTE=part time employee
AHT=average handling time
LH=lost hours
CSAT=customer satisfaction
QA=Quality Assurance
FCR=first call resolution
rto=return to office
AHOD=All hands on deck
ZTP=Zero tolerance policy
VTO=Voluntary time off
WFH=work from home
SL=sick leave
SLs=sick leaves
PH=Philippines